0 8 6 5 7 7 2 4 6 2 0 
8 3 9 6 3 8 3 9 5 6 4 
4 9 5 3 6 9 9 4 6 8 9 
6 8 3 9 7 3 4 4 2 5 4 
2 5 8 3 4 9 3 2 3 9 1 
4 2 4 6 9 3 5 8 3 9 2 
9 5 6 2 6 7 9 2 6 8 2 
6 3 8 4 7 4 8 4 9 9 6 
5 8 5 4 4 7 5 9 4 8 4 
2 7 4 2 5 7 2 9 2 8 6 
0 4 9 4 4 2 7 5 3 1 0
